################
#00000000000000#
#00000000000000#
#00000000000000#
#00000##0000000#
#000000#0000000#
#000000#0000000#
#00000e#000e000#
#00000##000e000#
#00000000000000#
#00000000000000#
#00000p00000000#
#00000000000000#
#00000000000000#
#00000000000000#
################