################
#00000000000000#
#00000000000000#
#00000000000000#
#0000###0000000#
#0000#p#0000000#
#0000#0#0000000#
#0000#e#000e000#
#0000###000e000#
#00000000e00000#
#00000e00000000#
#00e00000000000#
#00000000000000#
#000t0000000000#
#00000000000000#
################